############
#        O #
# P     ####
#          #
#######    #
# O     ## #
#       ## #
#          #
# XX       #
#        # #
############